[
    {
        "name":"lab1",
        "env_class":"Laberinto",
        "parameters": {
            "laberinto":[[0,0,0,1,0,0,0,0,0,0,0,0],
						[0,1,0,1,0,0,0,0,0,0,0,0],
						[0,1,0,1,0,0,0,1,0,0,0,0],
						[0,0,0,1,1,1,0,0,0,0,0,0],
						[0,0,0,1,0,0,0,0,0,1,1,1],
						[0,0,0,0,0,1,1,1,0,1,0,0],
						[0,0,0,1,1,0,0,0,0,1,1,0],
						[0,1,0,1,0,0,1,0,0,1,0,0],
						[0,1,0,0,0,1,0,0,0,1,0,1],
						[0,0,0,0,0,0,0,0,0,1,0,0],
						[0,1,0,0,0,0,1,1,1,1,1,0],
						[0,1,0,0,0,0,0,0,0,0,0,0]],
            "aleatorio": "True"
                    }
    },
    {
        "name":"lab2",
        "env_class":"Laberinto",
        "parameters": {
            "laberinto":[[0,0,0,0,0,0,1,0,1,0,0,0],
                        [0,1,1,0,1,0,0,0,1,0,1,0],
                        [0,1,0,0,1,0,1,1,1,0,1,0],
                        [0,1,0,1,1,0,0,0,0,0,0,0],
                        [0,1,0,0,1,1,1,0,1,1,1,0],
                        [0,1,1,0,0,0,0,0,0,0,0,0],
                        [0,0,0,0,0,1,1,1,1,0,1,0],
                        [1,1,1,1,0,1,0,0,1,0,1,0],
                        [0,0,0,1,0,0,0,0,0,0,1,0],
                        [0,1,0,1,1,1,1,1,1,0,1,0],
                        [0,1,0,0,0,0,1,0,1,1,1,0],
                        [0,1,0,0,1,0,0,0,0,0,0,0]],
            "aleatorio": "True"
                    }
    },
    {
        "name":"lab3",
        "env_class":"Laberinto",
        "parameters": {
            "laberinto":[[0,0,0,0,0,0,0,0,0,0,0,0],
                        [0,0,1,0,0,0,0,0,0,1,0,0],
                        [0,0,1,0,0,0,0,0,0,1,0,0],
                        [0,0,1,0,0,0,0,0,0,1,0,0],
                        [0,0,1,0,0,0,0,0,0,1,0,0],
                        [0,0,0,0,0,0,0,0,0,0,0,0],
                        [0,1,0,0,0,0,0,0,0,0,1,0],
                        [0,0,1,0,0,0,0,0,0,1,0,0],
                        [0,0,0,1,0,0,0,0,1,0,0,0],
                        [0,0,0,0,1,1,1,1,0,0,0,0],
                        [0,0,0,0,0,1,1,0,0,0,0,0],
                        [0,0,0,0,0,0,0,0,0,0,0,0]],
            "aleatorio": "True"
                    }
    }
]


